30
20
0 0 0 0 0 0 0 0 0 0 0 0 0 0 0 0 0 0 0 0 0 0 0 0 0 0 0 0 0 0
2 9 9 9 9 9 3 0 0 0 0 0 0 0 0 0 0 0 0 0 0 0 0 0 0 0 0 0 0 0
5 8 8 8 8 8 4 0 0 2 3 0 0 0 0 0 0 0 0 0 0 0 0 0 0 0 0 0 0 0
0 0 0 0 0 0 0 0 12 6 7 0 0 0 0 0 0 0 0 0 0 0 0 0 0 0 0 0 0 0
0 0 0 0 0 0 0 0 0 6 7 0 0 0 0 0 0 0 0 0 0 0 0 0 0 0 0 0 0 0
0 0 0 0 0 0 12 0 0 6 1 9 9 9 3 0 10 0 2 9 3 0 0 2 9 9 9 9 3 10
0 0 0 12 0 0 0 0 0 6 1 1 1 1 7 0 10 0 6 1 7 11 11 6 1 1 1 1 7 10
0 0 0 0 0 0 0 0 0 6 1 1 1 1 7 0 10 0 6 1 1 9 9 1 1 1 1 1 7 10
0 0 0 0 0 0 0 0 0 6 1 1 1 1 7 0 10 0 6 1 1 1 1 1 1 1 1 1 7 10
0 12 0 0 0 0 0 0 0 5 8 8 8 8 4 0 10 0 5 8 8 8 8 8 8 8 8 8 4 10
0 0 0 0 0 0 0 0 0 0 0 0 0 0 0 0 10 0 0 0 0 0 0 0 0 0 13 0 0 10
0 0 0 0 0 0 12 0 0 0 0 0 0 0 0 0 0 0 0 0 0 0 0 0 0 0 13 0 0 10
0 0 0 0 0 0 0 0 0 0 0 0 0 0 0 0 0 0 0 0 0 0 0 0 13 13 13 0 0 10
0 12 0 0 0 0 0 0 0 0 0 0 0 0 2 9 9 3 0 0 0 0 0 0 0 0 0 0 0 10
0 0 0 0 0 0 0 0 0 0 0 0 0 0 6 1 1 7 0 0 0 0 0 0 0 0 0 0 0 10
0 0 0 0 0 12 0 0 0 2 9 9 9 9 8 8 1 1 9 9 3 0 0 2 9 9 9 9 3 0
0 0 0 0 0 0 0 0 0 6 1 1 1 7 0 0 6 1 1 1 7 0 0 6 1 1 1 1 7 0
0 0 0 0 0 0 0 0 0 6 1 1 1 7 0 0 6 1 1 1 1 9 9 1 1 1 1 1 7 0
0 0 0 0 0 0 0 0 0 6 1 1 1 1 9 9 1 1 1 1 1 1 1 1 1 1 1 1 7 0
0 0 0 0 0 0 0 0 0 5 8 8 8 8 8 8 8 8 8 8 8 8 8 8 8 8 8 8 4 0
